00000000000000000000000000000000
00000000000011111111000000000000
00000000001111111111111000000000
00000000111111111111111110000000
00000001111111111111111111000000
00000011111111111111111111100000
00000111111111111111111111110000
00001111111111111111111111111000
00011111111111111111111111111000
00011111111111111111111111111100
00111111111111111111111111111100
00111111111111111111111111111110
01111111111111111111111111111110
01111111111111111111111111111110
01111111111111111111111111111110
01111111111111111111111111111110
01111111111111111111111111111110
01111111111111111111111111111110
01111111111111111111111111111110
01111111111111111111111111111110
01111111111111111111111111111110
01111111111111111111111111111110
01111111111111111111111111111110
00111111111111111111111111111100
00011111111111111111111111111100
00011111111111111111111111111000
00001111111111111111111111110000
00000111111111111111111111110000
00000011111111111111111111100000
00000000111111111111111110000000
00000000011111111111111100000000
00000000000000000000000000000000
